R    2000 1000


 NO ./textures/greystone.xpm
SO  ./textures/colorstone.xpm
WE ./textures/redbrick.xpm
EA   ./textures/wood.xpm
S   ./textures/barrel.xpm



C 135,206,255
F 96,128,56

        1111111111111111111111111
        1000000000110000000000001
        1011000001110000002000001
        10010000000000000000000W1
111111111011000001110000000000001 
100000000011000001110111110111111
11110111111111011100000010001
11110111111111011101010110001
11000000110101011100000022201
10002000000000001100000021201
10000000000000001101010022201
110000011101010111110000200111
11110111 1110101 101111020001
11111111 1111111 111111111111
111111