NO ./textures/greystone.xpm
R 1920 1080
SO    ./textures/colorstone.xpm
WE ./textures/redbrick.xpm
EA ./textures/wood.xpm

S ./textures/barrel.xpm
C 135,206,235
F 96,128,56

        1111111111111111111111111
        1000000000110000000000001
        1011000001110000002000001
        1001000000000000000000001
111111111011000001110000000000001
100000000011000001110111110111111
11110111111111011100000010001
11110111111111011101010110001
11000000110101011100000010001
1000200000000000110000000N001
10000000000000001101010000001
110000011101010111110111100111
11110111 1110101 101111010001
11111111 1111111 111111111111