R 800 600


NO ./textures/greystone.xpm
SO  ./textures/colorstone.xpm
WE ./textures/redbrick.xpm
EA   ./textures/wood.xp
S   ./textures/barrel.xpm


C 135,0,255



F 96,128,56

        1111111111111111111111111
        1000000000000000000000001
        1011000000222200002000001
        1001000002222200000000001
111111111011000000222200000000001 
1000000000110000000000000000000N1
111101111111110111000000100011111111111111111111111111
11110111111111011101010110001
11000000110101011100000022201
10002000000000001100000021201
10000000000000001101010022201
110000011101010111110000200111
11110111 1110101 101111020001
11111111 1111111 11111111111111111111