R      1920 1080
NO      ./textures/colorstone.xpm
SO ./textures/wood.xpm
WE             ./textures/greystone.xpm
EA ./textures/redbrick.xpm
S    ./textures/barrel.xpm

F   96,128,56
C   1,187,242


        1111111111111111111111111
        1000000000110000000000001
        1011000001110002000000001
        1001000000000000000000001
111111111011000001110000000002001
100000000011000001110111110111111
11110111111111011100000000001
11110111111111011100000020001
11000000110101011100000000001
1000000000020000110E020202021
10000200000000001100000000001
1100000111010101111100022000111
11110111 1110101 101111010001
11111111 1111111 111111111111