R 800 600

NO ./textures/barrel.xpm
SO ./textures/barrel.xpm
WE             ./textures/barrel.xpm
EA ./textures/barrel.xpm
S    ./textures/barrel.xpm

F   35,77,56
C   1,187,242


11111111111111111
10000000000000001
10200000200000201111111111
10000222222200001
10002222N22220001
10000222222200001
10202020002020201
10000000000000001
10002000200200001
10000000000000001
10200000200002001
10000000000000001
11111111111111111111111